77777777777777777777777777777777777
71000400000000003000000000000000427
70506050605060506050605060506050607
70000000000000000000000000000000007
74506050605067576757675060506050607
70040000000000000000000000030000007
70506050605067576757675060506050607
70000000000000000000000000000400007
73506050605067576757675060506050607
70000000000000003000000000000000007
70506050605067576757675060506050637
70000000000000000000000000000000007
70506050605067576757675060506050607
70000000000000040000000000000000007
70506050605067576757675060506050637
70000000000000000000000000000000007
70506050605067576757675060506050607
70040000000000003000000000000000007
70506050605067576757675060506050607
70000000000000003000000000000000007
70506050605060506050605060506050647
72400000000000003000000000000000027
77777777777777777777777777777777777