77777777777777777777777777777777777
71040000000000000000000000000000027
70777077777077707070707070707070707
70000000000077700000000000000000007
70707070707070707070707070707070707
70000000000000000000004000004000007
70707070707070707070707070707070707
70000000000000000000000000000000007
70707070707070707777777770707070707
70000000000000000000007000000000007
70707070707070707070707070707070707
70000000000000000000000000000000007
70707070707070707070707070707070707
70030000004000000000000000000000307
70707070707070707070707070707070707
70000000000000000000000000000000007
70707070707070707070707070707070707
70000000000000000000000000000000007
70707070707070707070707070707070707
70000000000000000000000000000000007
70707070707070707070707070707070707
70000000000000000000000000000000027
77777777777777777777777777777777777