77777777777777777777777777777777777
71000000000000000000000000000000007
70505050505050505050505050505050507
70000000000000030000000000000000007
70505050505050505050505050505050507
70000000000000000000000000000000007
70505050505050505050505050505050507
70000000000000000000000300000000007
70505050505050505050505050505050507
70000000000000000000000000300000007
70505050505050505050505050505050507
70000000000000000000000000000000007
70505050505050505050505050505050507
70000000000000000000000000000000007
70505050505050505050505050505050507
70000000000000000000000000000000007
70505050505050505050505050505050507
70000003000000000000000000000000007
70505050505050505050505050505050507
70000000000000000000000000000000007
70505050505050505050505050505050507
70000000000300030000000000000000027
77777777777777777777777777777777777