77777777777777777777777777777777777
71700000000000000000000000000000007
70700707070707070707070707070707077
70700000000000000000000000000000007
70777070707070707070707070707070707
70000000000000000000070000000000007
70707070707070707070707070707070707
70000000000000000000000000000000007
70000000000000000000000000000000007
70000000000000000000000000000000007
70000000000000000000000000000000007
70000000000000000000000000000000007
70000000000000000000000000000000007
70000000000000000000000000000000007
70000000000000000000000000000000007
70000000000000000000000000000000007
70000000000000000000000000000000007
70000000000000000000000000000000007
70000000000000000000000000000000007
70000000000000000000000000000000007
70000000000000000000000000000000007
70000000000000000000000000000000007
77777777777777777777777777777777777