77777777777777777777777777777777777
71040000000000000000000000000000027
70707070707070707070707070707070707
70000000000000000000000000000000007
73707070707070707070707070707070707
70000000000000000000000000000000007
70707070707070707070707070707070707
70000000000000000000000000000000007
70707070707070707070707070707070707
70000000000000000000000000000000007
70707070707070707070707070707070707
70000000000000000000000000000000007
70707070707070707070707070707070707
70000000000000000000000000000000007
70707070707070707070707070707070707
70000000000000000000000000000000007
70707070707070707070707070707070707
70000000000000000000000000000000007
70707070707070707070707070707070707
70000000000000000000000000000000007
70707070707070707070707070707070707
70000000000000000000000000000000027
77777777777777777777777777777777777