77777777777777777777777777777777777
71400000000000000000000000000000007
70646460606060606460646060606060607
70400000000000000000000000000000007
70606060606060606060606060606060607
70300000000000000000000000000000007
70606060606060606060606060606060607
70000000000000000000000000000000007
76666666666666660006666666666666667
70000000000000000000000000000000007
70004444000030000300003000044440007
70000000000000000000000000000000007
70006666666666660006666666666660007
70000000000000000000000000000000007
70606060606060606060606060606060607
70000000000000000000000000000000007
70606060606060306363606060606060607
70000000000000000000000000000000007
70606060606060606060606060606060607
70000000000000000000000000000000007
70646460606060606060606060606464607
72000000000000000000000000000000027
77777777777777777777777777777777777