77777777777777777777777777777777777
71000000000000000000000000000000007
70707070707070707770707070707070707
70000000000000000700000000000000007
70707070707070707770707070707070707
70000000000000000700000000000000007
70707070707070707770707070707070707
70000000000000000000000000000000007
70707070707070707070707070707070707
70000000000000000000000000000000007
70707070707070707070707070707070707
70000000000000000000007770000000007
70707077777770707070707770707070707
70000000000000000000007770000000007
70707070707070707070700000707070707
70000000000000000000000000000000007
70707070707070707070707070707070707
70000000000000000000000000000000007
70707070707070707070707070707070707
70000000000070000000000000000000007
70707070707070707070707070707070707
70000000000070000000000000000000027
77777777777777777777777777777777777