77777777777777777777777777777777777
71040404040404040404040404040404027
70505050505050505050505050505050507
73040404040404040404040404040404047
70505050505050505050505050505050507
74040404040404040404040404040404047
70505050505050505050505050505050507
74040404040404040404040404040404047
70505050505050505050505050505050507
74040404040404040404040404040404047
70505050505050505050505050505050507
74040404040404040404040404040404047
70505050505050505050505050505050507
74040404040404040404040404040404047
70505050505050505050505050505050507
74040404040404040404040404040404047
70505050505050505050505050505050507
74040404040404040404040404040404047
70505050505050505050505050505050507
74040404040404040404040404040404047
70505050505050505050505050505050507
74040404040404040404040404040404027
77777777777777777777777777777777777